"player_id","player_name","pts","fgm","fga","fg3m","fg3a","fg2m","fg2a","ftm","fta","reb","oreb","dreb","ast","stl","tov","blk","pf","min"
1713,"Vince Carter",1461,503,1241,292,777,211,464,163,218,569,85,484,289,146,134,89,400,4154
1717,"Dirk Nowitzki",2069,777,1812,281,751,496,1061,234,270,949,50,899,237,82,120,101,335,4114
1718,"Paul Pierce",81,28,70,15,43,13,27,10,13,48,1,47,10,4,16,5,40,278
1891,"Jason Terry",473,164,397,113,286,51,111,32,38,154,20,134,157,88,61,33,147,2179
1897,"Metta World Peace",57,19,68,9,38,10,30,10,16,20,5,15,11,10,7,2,18,162
1938,"Manu Ginobili",1093,372,902,153,419,219,483,196,238,299,47,252,346,125,201,32,245,2592
2034,"Mike Miller",28,9,23,8,20,1,3,2,2,38,2,36,22,2,13,0,9,152
2037,"Jamal Crawford",2338,841,2050,287,838,554,1212,369,426,313,46,267,628,134,328,35,275,5026
2199,"Tyson Chandler",870,335,514,0,1,335,513,200,304,1264,379,885,120,70,166,74,342,3330
2200,"Pau Gasol",1685,632,1325,105,237,527,1088,316,433,1257,258,999,440,53,205,164,260,3800
2207,"Joe Johnson",1087,419,986,146,403,273,583,103,122,415,47,368,227,54,118,25,160,3046
2210,"Richard Jefferson",478,165,370,64,193,101,177,84,115,220,30,190,93,28,57,11,164,1780
2216,"Zach Randolph",1885,794,1727,72,241,722,1486,225,300,995,279,716,249,80,215,20,255,3294
2225,"Tony Parker",1589,656,1420,46,157,610,1263,231,319,291,30,261,687,83,232,10,197,3655
2365,"Chris Andersen",28,9,22,0,3,9,19,10,14,31,9,22,5,5,5,7,20,115
2399,"Mike Dunleavy",275,93,220,53,134,40,86,36,45,115,18,97,50,15,28,7,67,845
2403,"Nene",1100,441,752,3,14,438,738,215,351,581,183,398,136,102,122,68,373,2501
2440,"Matt Barnes",527,185,473,87,263,98,210,70,89,384,70,314,195,48,107,26,185,1780
2449,"Luis Scola",184,71,151,17,50,54,101,25,37,139,51,88,37,14,34,4,63,465
2544,"LeBron James",5710,2151,4019,384,1075,1767,2944,1024,1480,1813,251,1562,1847,280,847,148,364,7756
2546,"Carmelo Anthony",3054,1123,2678,341,959,782,1719,467,580,945,138,807,321,111,260,90,427,5339
2548,"Dwyane Wade",2944,1129,2597,163,517,966,2080,523,703,807,182,625,757,206,444,126,354,5215
2555,"Nick Collison",64,27,42,0,1,27,41,10,21,51,16,35,16,2,11,2,24,203
2561,"David West",811,351,630,6,16,345,614,103,135,441,111,330,289,89,158,123,225,1856
2564,"Boris Diaw",338,146,327,20,81,126,246,26,35,158,46,112,170,18,87,9,83,1287
2571,"Leandro Barbosa",419,172,392,35,98,137,294,40,45,104,15,89,81,31,48,8,82,960
2585,"Zaza Pachulia",1066,398,764,0,7,398,757,270,343,996,328,668,332,128,216,67,439,3113
2592,"James Jones",132,44,92,31,66,13,26,13,20,37,3,34,14,6,10,10,37,380
2594,"Kyle Korver",1950,662,1482,464,1083,198,399,162,187,513,25,488,279,90,183,60,343,4658
2617,"Udonis Haslem",64,25,71,1,23,24,48,13,21,73,14,59,13,6,13,3,34,278
2730,"Dwight Howard",2464,937,1593,1,9,936,1584,589,1054,2035,575,1460,213,119,394,227,486,4885
2731,"Emeka Okafor",114,48,95,0,0,48,95,18,22,120,47,73,8,8,13,25,30,352
2733,"Shaun Livingston",1041,454,869,1,10,453,859,132,172,399,102,297,393,104,158,68,311,3447
2734,"Devin Harris",1460,455,1142,199,604,256,538,351,433,366,35,331,410,125,189,35,392,3501
2736,"Luol Deng",584,224,544,65,209,159,335,71,98,368,83,285,93,64,58,28,85,1892
2738,"Andre Iguodala",1347,518,1037,145,438,373,599,166,256,802,149,653,687,191,177,128,291,5204
2743,"Kris Humphries",257,87,214,19,54,68,160,64,82,206,60,146,29,15,28,21,69,689
2744,"Al Jefferson",787,346,679,0,4,346,675,95,121,421,105,316,87,35,54,39,191,1412
2747,"JR Smith",1087,390,1030,250,691,140,339,57,81,366,46,320,224,119,118,25,257,3658
2749,"Jameer Nelson",934,363,848,147,397,216,451,61,83,296,41,255,564,81,195,12,278,3065
2754,"Tony Allen",746,318,686,19,66,299,620,91,151,438,186,252,107,126,119,32,227,2188
2756,"Sasha Vujacic",124,42,136,23,74,19,62,17,24,59,12,47,52,13,16,2,38,408
2757,"Beno Udrih",227,92,197,11,32,81,165,32,34,57,6,51,131,13,36,0,29,561
2772,"Trevor Ariza",2581,888,2185,506,1451,382,734,299,379,1123,137,986,532,336,231,54,395,7392
2863,"Damien Wilkins",33,13,39,4,18,9,21,3,4,16,5,11,9,2,5,1,7,152
101106,"Andrew Bogut",154,73,142,0,1,73,141,8,16,351,94,257,75,20,70,46,148,936
101107,"Marvin Williams",2349,830,1919,390,1041,440,878,299,359,1277,239,1038,294,185,173,152,406,6439
101108,"Chris Paul",3091,1043,2303,395,1036,648,1267,610,684,882,113,769,1493,329,427,40,433,5623
101109,"Raymond Felton",1245,500,1201,147,435,353,766,98,121,408,62,346,446,125,173,44,245,3447
101112,"Channing Frye",1069,385,849,208,529,177,320,91,107,477,53,424,103,57,87,55,251,2433
101114,"Deron Williams",701,263,600,85,234,178,366,90,109,147,14,133,360,31,138,8,138,1658
101123,"Gerald Green",1434,494,1223,305,850,189,373,141,169,399,61,338,98,66,111,49,261,2941
101127,"Jarrett Jack",472,191,446,25,87,166,359,65,77,191,22,169,353,37,118,4,102,1583
101133,"Ian Mahinmi",678,250,463,3,18,247,445,175,264,590,230,360,97,96,155,82,404,2199
101135,"David Lee",576,248,420,0,0,248,420,80,113,441,149,292,124,31,82,40,125,1480
101138,"Brandon Bass",292,107,186,1,3,106,183,77,88,129,43,86,21,14,29,11,45,574
101139,"CJ Miles",1853,620,1557,400,1066,220,491,213,248,476,61,415,139,109,109,61,364,3970
101141,"Ersan Ilyasova",2274,828,1884,291,815,537,1069,327,416,1188,327,861,283,151,236,69,540,5107
101145,"Monta Ellis",630,247,557,43,135,204,422,93,128,204,19,185,236,78,135,27,149,1997
101150,"Lou Williams",4701,1494,3473,454,1255,1040,2218,1259,1433,622,106,516,1058,222,575,50,278,6575
101161,"Amir Johnson",1063,432,787,49,138,383,649,150,226,843,288,555,318,112,177,119,502,3312
101162,"Marcin Gortat",1806,779,1420,0,2,779,1418,248,370,1733,486,1247,337,86,268,146,480,5392
101179,"Ronnie Price",14,4,24,3,17,1,7,3,4,11,3,8,18,11,3,1,14,135
101181,"Jose Calderon",509,193,439,79,218,114,221,44,53,218,40,178,320,54,117,6,181,2089
101187,"Alan Anderson",86,30,80,14,44,16,36,12,16,24,3,21,11,3,7,0,35,309
200746,"LaMarcus Aldridge",4705,1871,3715,60,190,1811,3525,903,1082,1902,669,1233,485,132,353,285,498,7537
200751,"Randy Foye",357,118,325,67,203,51,122,54,63,155,9,146,135,35,80,9,99,1286
200752,"Rudy Gay",2163,830,1725,153,415,677,1310,350,430,951,174,777,338,144,266,98,336,4090
200755,"JJ Redick",3743,1252,2796,634,1533,618,1263,605,675,535,40,495,526,121,302,36,377,6694
200757,"Thabo Sefolosha",946,363,784,107,282,256,502,113,151,554,91,463,167,191,113,48,197,3015
200765,"Rajon Rondo",1499,635,1487,151,425,484,1062,78,132,861,138,723,1361,226,447,28,363,4917
200768,"Kyle Lowry",3537,1133,2601,588,1517,545,1084,683,820,1032,155,877,1518,264,538,69,528,6965
200771,"Sergio Rodriguez",530,210,536,92,252,118,284,18,27,157,21,136,344,49,128,4,95,1517
200782,"PJ Tucker",1643,578,1446,331,893,247,553,156,212,1407,331,1076,272,326,203,84,653,7318
200794,"Paul Millsap",2684,954,2072,172,513,782,1559,604,815,1283,329,954,498,212,326,160,468,5378
200826,"J.J. Barea",1597,606,1418,206,589,400,829,179,231,380,37,343,838,71,278,5,163,3130
201142,"Kevin Durant",5374,1902,3631,427,1113,1475,2518,1143,1294,1474,103,1371,1123,174,570,302,405,7104
201143,"Al Horford",2804,1134,2277,256,671,878,1606,280,350,1454,318,1136,959,154,349,250,402,6444
201144,"Mike Conley",3098,1018,2297,350,922,668,1375,712,840,507,71,436,931,198,304,44,273,5009
201145,"Jeff Green",2430,841,1863,217,683,624,1180,531,608,769,156,613,317,121,251,86,412,5456
201147,"Corey Brewer",902,342,787,72,272,270,515,146,201,396,101,295,201,172,123,41,335,2982
201148,"Brandan Wright",328,142,237,0,1,142,236,44,68,173,64,109,28,24,18,46,74,826
201149,"Joakim Noah",542,214,425,0,2,214,423,114,191,655,226,429,196,52,112,70,228,1750
201150,"Spencer Hawes",337,134,277,25,81,109,196,44,52,191,38,153,81,15,49,30,77,797
201152,"Thaddeus Young",2793,1226,2392,154,445,1072,1947,187,313,1483,507,976,478,371,323,101,504,7336
201155,"Rodney Stuckey",281,91,244,19,60,72,184,80,107,84,6,78,84,16,53,0,44,692
201156,"Nick Young",1381,476,1130,296,755,180,375,133,155,264,45,219,96,75,77,22,241,2984
201158,"Marco Belinelli",2580,886,2069,398,1073,488,996,410,455,527,50,477,427,145,236,29,302,5540
201160,"Jason Smith",598,240,503,50,136,190,367,68,88,363,98,265,65,27,87,74,242,1546
201162,"Jared Dudley",873,306,707,159,434,147,273,102,146,474,73,401,282,102,144,43,370,3272
201163,"Wilson Chandler",2160,828,1843,257,730,571,1113,247,333,1073,253,820,382,119,252,90,451,5717
201166,"Aaron Brooks",397,149,369,59,159,90,210,40,51,86,25,61,145,31,77,9,121,1082
201167,"Arron Afflalo",694,250,582,89,221,161,361,105,119,191,13,178,108,25,63,15,160,2260
201177,"Josh McRoberts",107,44,119,13,32,31,87,6,9,74,23,51,50,10,23,4,33,387
201188,"Marc Gasol",3775,1356,3063,312,861,1044,2202,751,922,1683,218,1465,992,205,515,286,573,7375
201196,"Ramon Sessions",448,142,380,29,88,113,292,135,175,111,17,94,206,41,76,5,72,1203
201202,"Joel Anthony",25,10,16,0,0,10,16,5,8,31,8,23,3,2,4,6,11,123
201228,"C.J. Watson",281,96,248,32,105,64,143,57,66,89,16,73,114,43,47,2,84,1011
201229,"Anthony Tolliver",1490,473,1082,330,810,143,272,214,275,655,116,539,213,83,150,62,344,4321
201563,"Michael Beasley",1685,700,1366,55,146,645,1220,230,303,667,150,517,201,72,236,80,279,2871
201565,"Derrick Rose",2280,904,1916,74,236,830,1680,398,459,421,112,309,540,82,264,33,157,3897
201566,"Russell Westbrook",6261,2211,5101,416,1320,1795,3781,1423,1857,2475,398,2077,2444,421,1144,84,635,8353
201567,"Kevin Love",2555,813,1879,335,866,478,1013,594,675,1451,282,1169,267,102,254,50,299,4139
201568,"Danilo Gallinari",2812,846,1890,323,807,523,1083,797,880,843,102,741,354,102,207,48,252,4864
201569,"Eric Gordon",3563,1211,2924,680,1869,531,1055,461,568,519,71,448,471,133,341,95,409,6631
201571,"D.J. Augustin",2330,757,1734,340,857,417,877,476,559,480,86,394,922,137,341,5,310,5566
201572,"Brook Lopez",3509,1279,2751,433,1224,846,1527,518,655,1093,228,865,400,119,364,401,576,6281
201573,"Jerryd Bayless",549,202,524,85,249,117,275,60,82,154,29,125,186,41,87,8,151,1654
201575,"Brandon Rush",197,70,187,44,114,26,73,13,18,99,16,83,45,22,28,23,42,1031
201577,"Robin Lopez",2299,1028,1955,11,47,1017,1908,232,317,1096,518,578,293,43,294,248,384,5575
201578,"Marreese Speights",1113,382,897,189,510,193,387,160,192,506,109,397,105,31,109,63,335,1959
201579,"Roy Hibbert",221,80,147,0,0,80,147,61,75,152,54,98,21,8,32,46,100,684
201580,"JaVale McGee",1679,744,1179,1,21,743,1158,190,315,979,354,625,102,87,175,272,408,3027
201582,"Alexis Ajinca",207,89,178,0,4,89,174,29,40,177,46,131,12,20,31,22,77,584
201583,"Ryan Anderson",1659,551,1322,344,885,207,437,213,259,715,224,491,147,59,111,36,293,4159
201584,"Courtney Lee",1884,717,1588,237,602,480,986,213,243,537,92,445,396,182,167,44,282,5200
201585,"Kosta Koufos",1103,511,934,0,1,511,933,81,160,1052,319,733,170,98,137,98,386,3307
201586,"Serge Ibaka",3244,1314,2643,280,783,1034,1860,336,420,1617,363,1254,236,99,309,326,635,6524
201587,"Nicolas Batum",2603,916,2187,343,977,573,1210,428,503,1177,174,1003,1052,222,442,95,321,6959
201588,"George Hill",1954,695,1495,227,591,468,904,337,421,496,104,392,525,163,224,46,344,4660
201589,"Darrell Arthur",316,117,262,61,140,56,122,21,25,127,28,99,51,27,51,24,98,782
201596,"Mario Chalmers",507,168,443,53,191,115,252,118,138,157,13,144,197,79,117,14,179,1426
201599,"DeAndre Jordan",2714,1071,1601,0,2,1071,1599,572,1001,3187,852,2335,369,132,405,277,582,7041
201600,"Omer Asik",107,40,87,0,0,40,87,27,52,210,57,153,18,7,23,14,71,663
201601,"Luc Mbah a Moute",964,365,741,108,289,257,452,126,187,363,68,295,96,154,116,61,230,3408
201609,"Goran Dragic",3273,1197,2632,285,753,912,1879,594,749,696,136,560,956,182,449,30,460,5826
201627,"Anthony Morrow",271,98,252,41,133,57,119,34,37,31,12,19,25,24,6,2,44,711
201628,"Bobby Brown",112,42,118,25,75,17,43,3,4,13,0,13,25,5,14,0,11,237
201933,"Blake Griffin",4399,1534,3308,338,957,1196,2351,993,1301,1490,285,1205,1036,149,560,68,495,6666
201935,"James Harden",7365,2168,4891,905,2506,1263,2385,2124,2466,1566,202,1364,2123,405,1166,146,628,8374
201936,"Tyreke Evans",2127,773,1839,233,620,540,1219,348,461,603,90,513,559,150,296,44,273,3799
201937,"Ricky Rubio",2708,902,2207,235,723,667,1484,669,767,899,145,754,1508,340,582,31,588,6623
201939,"Stephen Curry",5226,1735,3647,890,2100,845,1547,866,951,983,142,841,1195,314,584,50,463,6594
201942,"DeMar DeRozan",5495,1997,4271,129,456,1868,3815,1372,1647,1163,183,980,1182,249,554,71,462,8016
201943,"Brandon Jennings",650,219,607,88,285,131,322,124,162,227,34,193,439,76,146,8,127,2010
201945,"Gerald Henderson",662,234,553,61,173,173,380,133,165,185,34,151,112,40,62,15,129,1669
201949,"James Johnson",2191,841,1762,194,590,647,1172,315,447,910,149,761,691,181,386,164,503,5197
201950,"Jrue Holiday",3986,1567,3296,338,1000,1229,2296,514,677,963,183,780,1492,332,617,162,482,7514
201951,"Ty Lawson",681,237,522,34,118,203,404,173,217,179,44,135,334,74,129,6,119,1733
201952,"Jeff Teague",2758,932,2119,209,585,723,1534,685,807,645,73,572,1474,245,490,73,426,6236
201954,"Darren Collison",2608,964,2011,248,574,716,1437,432,505,562,96,466,1139,269,325,33,379,6232
201956,"Omri Casspi",712,283,532,40,108,243,424,106,156,427,74,353,114,61,89,31,156,1911
201959,"Taj Gibson",2598,1094,1983,21,82,1073,1901,389,520,1527,524,1003,256,156,267,163,567,6396
201960,"DeMarre Carroll",2365,772,1910,360,1021,412,889,461,605,1103,236,867,306,171,230,67,422,5772
201961,"Wayne Ellington",2057,700,1712,514,1345,186,367,143,170,457,55,402,221,142,122,18,256,4829
201962,"Toney Douglas",117,43,117,7,42,36,75,24,29,61,13,48,56,18,21,5,50,395
201967,"Dante Cunningham",1046,413,881,159,414,254,467,61,97,763,182,581,135,105,83,71,282,4136
201973,"Jonas Jerebko",1187,436,958,179,475,257,483,136,174,806,184,622,209,76,109,47,386,3587
201975,"Jodie Meeks",865,281,688,136,365,145,323,167,192,215,21,194,123,64,75,9,101,1962
201976,"Patrick Beverley",1369,470,1139,246,630,224,509,183,235,826,187,639,613,185,210,73,521,4528
201977,"Marcus Thornton",219,84,210,28,80,56,130,23,27,76,22,54,41,19,25,3,48,576
201980,"Danny Green",1918,686,1640,432,1066,254,574,114,141,790,132,658,360,206,225,190,413,5814
201988,"Patty Mills",2389,835,1966,460,1173,375,793,259,301,477,74,403,754,169,300,24,366,5772
202066,"Garrett Temple",1639,590,1401,261,711,329,690,198,259,552,82,470,398,217,227,85,480,5387
202083,"Wesley Matthews",2628,895,2242,477,1284,418,958,361,443,627,78,549,542,207,276,48,461,6719
202322,"John Wall",3265,1172,2654,202,608,970,2046,719,943,592,96,496,1503,263,601,123,302,5347
202323,"Evan Turner",1729,697,1572,84,302,613,1270,251,316,819,103,716,661,133,313,71,394,5295
202324,"Derrick Favors",2317,961,1738,34,151,927,1587,361,552,1417,497,920,247,155,232,228,430,5112
202325,"Wesley Johnson",717,268,696,114,371,154,325,67,94,469,67,402,107,119,91,104,292,2847
202326,"DeMarcus Cousins",3640,1231,2667,261,752,970,1915,917,1208,1658,300,1358,696,219,583,213,570,4977
202327,"Ekpe Udoh",281,110,192,0,1,110,191,61,86,240,95,145,81,53,33,105,141,1129
202328,"Greg Monroe",1705,697,1301,1,9,696,1292,310,430,1054,343,711,325,150,266,69,329,3339
202329,"Al-Farouq Aminu",1936,670,1641,291,831,379,810,305,389,1586,286,1300,287,207,245,117,381,6136
202330,"Gordon Hayward",2428,842,1793,226,606,616,1187,518,616,717,100,617,496,135,245,43,222,4391
202331,"Paul George",5668,1905,4302,731,1862,1174,2440,1127,1325,1567,235,1332,832,450,637,100,653,8425
202332,"Cole Aldrich",117,50,101,0,0,50,101,17,28,173,54,119,28,27,18,24,96,586
202334,"Ed Davis",1086,431,736,0,3,431,733,224,354,1513,495,1018,127,82,167,107,551,3704
202335,"Patrick Patterson",992,342,869,206,561,136,308,102,136,633,136,497,164,104,93,59,253,3732
202337,"Luke Babbitt",583,204,496,147,366,57,130,28,37,237,19,218,67,28,44,18,172,1784
202338,"Kevin Seraphin",232,109,198,0,2,109,196,14,22,142,41,101,23,7,29,20,66,561
202339,"Eric Bledsoe",3944,1387,2994,353,1047,1034,1947,817,1011,966,185,781,1218,356,605,102,505,6773
202340,"Avery Bradley",2175,866,2008,269,725,597,1283,174,225,625,130,495,368,160,278,35,400,5174
202344,"Trevor Booker",1137,482,934,33,111,449,823,140,203,889,260,629,220,103,186,49,271,2921
202347,"Quincy Pondexter",143,43,107,9,40,34,67,48,59,73,16,57,33,19,24,3,48,481
202348,"Jordan Crawford",300,117,245,45,109,72,136,21,27,38,6,32,70,12,30,3,37,496
202355,"Hassan Whiteside",2950,1242,2231,4,18,1238,2213,462,783,2523,724,1799,167,140,343,391,549,5557
202357,"Nemanja Bjelica",1598,606,1320,235,617,371,703,151,198,962,235,727,312,144,193,92,492,4354
202362,"Lance Stephenson",1370,541,1261,146,449,395,812,142,213,691,98,593,434,92,243,27,320,3330
202389,"Timofey Mozgov",532,221,421,4,19,217,402,86,108,362,136,226,54,21,105,44,172,1464
202391,"Jeremy Lin",1248,418,953,114,345,304,608,298,358,314,33,281,419,89,213,27,226,2347
202397,"Ish Smith",2153,923,2039,107,341,816,1698,200,280,604,71,533,981,153,281,64,376,5253
202498,"Lance Thomas",778,277,708,110,288,167,420,114,140,434,97,337,106,68,90,26,302,3104
202681,"Kyrie Irving",4878,1809,3748,517,1282,1292,2466,743,834,792,156,636,1188,251,491,75,446,6675
202682,"Derrick Williams",306,109,248,30,99,79,149,58,89,131,19,112,28,14,28,7,60,811
202683,"Enes Kanter",2948,1199,2133,15,74,1184,2059,535,666,1921,725,1196,288,100,363,101,508,5000
202684,"Tristan Thompson",1407,595,1052,0,3,595,1049,217,398,1505,585,920,196,83,159,117,367,4603
202685,"Jonas Valanciunas",2702,1082,1927,45,124,1037,1803,493,613,1838,515,1323,208,85,311,185,554,4881
202687,"Bismack Biyombo",1187,451,847,0,1,451,846,285,482,1282,382,900,173,57,213,227,463,4076
202688,"Brandon Knight",861,308,785,86,268,222,517,159,188,177,35,142,201,48,118,7,149,1876
202689,"Kemba Walker",5702,1962,4496,731,1934,1231,2562,1047,1229,917,129,788,1362,278,558,80,348,8349
202691,"Klay Thompson",4883,1874,3955,738,1766,1136,2189,397,474,861,117,744,531,205,371,121,413,7802
202692,"Alec Burks",1338,461,1136,133,386,328,750,283,343,547,66,481,225,94,160,34,216,3094
202693,"Markieff Morris",2451,940,2060,215,606,725,1454,356,435,1167,243,924,347,174,310,102,645,5609
202694,"Marcus Morris",2885,1060,2462,350,980,710,1482,415,512,1113,196,917,341,130,244,62,449,6095
202695,"Kawhi Leonard",3630,1248,2552,270,724,978,1828,864,997,911,164,747,480,257,291,88,218,4728
202696,"Nikola Vucevic",3700,1583,3225,171,510,1412,2715,363,481,2262,501,1761,706,213,385,225,481,6360
202697,"Iman Shumpert",1094,390,993,196,560,194,433,118,150,442,73,369,238,130,144,55,299,3694
202699,"Tobias Harris",4451,1684,3538,448,1152,1236,2386,635,749,1498,190,1308,563,182,352,111,481,8085
202700,"Donatas Motiejunas",156,60,144,11,47,49,97,25,51,104,28,76,33,18,34,12,61,492
202702,"Kenneth Faried",1159,460,829,8,32,452,797,231,339,865,348,517,93,72,115,76,257,2489
202703,"Nikola Mirotic",2300,802,1851,380,1053,422,798,316,389,1128,180,948,210,128,190,128,343,4422
202704,"Reggie Jackson",2668,971,2301,292,824,679,1477,434,506,455,95,360,852,117,361,18,424,4912
202705,"MarShon Brooks",331,127,271,34,86,93,185,43,56,66,20,46,50,20,37,7,39,582
202708,"Norris Cole",43,16,52,3,13,13,39,8,10,11,0,11,14,8,7,0,18,124
202709,"Cory Joseph",1926,781,1813,170,496,611,1317,194,259,777,129,648,846,240,275,53,412,6279
202710,"Jimmy Butler",4338,1425,3077,228,641,1197,2436,1260,1466,1126,329,797,968,382,362,95,301,7156
202711,"Bojan Bogdanovic",3708,1302,2748,463,1164,839,1584,641,753,880,100,780,391,158,371,16,413,7114
202713,"Kyle Singler",111,41,104,9,42,32,62,20,30,58,9,49,11,8,14,5,33,444
202714,"Shelvin Mack",1333,511,1198,131,389,380,809,180,258,395,61,334,609,143,245,15,275,3816
202718,"Chandler Parsons",681,251,638,105,308,146,330,74,95,244,24,220,167,57,91,21,150,1864
202720,"Jon Leuer",966,391,795,50,181,341,614,134,159,531,136,395,130,44,96,33,221,2483
202722,"Davis Bertans",1365,468,1053,308,763,160,290,121,143,515,63,452,220,81,111,89,301,3523
202730,"Lavoy Allen",177,77,168,0,1,77,167,23,33,219,105,114,57,18,29,24,78,868
202732,"DeAndre Liggins",253,95,248,36,99,59,149,27,45,183,27,156,102,84,62,28,162,1503
202734,"E'Twaun Moore",2355,962,1983,281,685,681,1298,150,201,517,125,392,453,169,223,52,425,5867
202738,"Isaiah Thomas",2782,873,1993,312,877,561,1116,724,807,284,64,220,624,90,323,17,242,3616
202779,"Dwight Buycks",215,82,198,15,45,67,153,36,41,41,12,29,59,19,39,2,39,426
202933,"Julyan Stone",19,6,13,6,13,0,0,1,2,29,1,28,26,4,7,2,21,176
202954,"Brad Wanamaker",140,50,105,16,39,34,66,24,28,41,3,38,56,12,19,2,34,344
203076,"Anthony Davis",5661,2080,4014,143,441,1937,3573,1358,1678,2387,533,1854,549,297,455,495,459,7284
203077,"Michael Kidd-Gilchrist",1851,735,1510,17,58,718,1452,364,488,1113,328,785,246,164,152,148,486,5386
203078,"Bradley Beal",5735,2084,4415,631,1678,1453,2737,936,1159,1014,203,811,1088,300,594,115,555,8694
203079,"Dion Waiters",1685,642,1551,246,674,396,877,155,240,346,33,313,434,94,237,38,228,3442
203080,"Thomas Robinson",241,105,196,0,1,105,195,31,66,223,84,139,31,26,46,9,76,559
203081,"Damian Lillard",6053,1963,4436,678,1851,1285,2585,1449,1596,1064,176,888,1472,233,615,81,417,8201
203082,"Terrence Ross",2290,842,1964,389,1050,453,914,217,257,559,55,504,261,186,187,73,307,4703
203083,"Andre Drummond",3646,1510,2844,7,56,1503,2788,619,1162,3594,1167,2427,439,374,527,354,759,7683
203084,"Harrison Barnes",4235,1567,3515,371,996,1196,2519,730,872,1223,227,996,383,164,318,42,344,7972
203085,"Austin Rivers",2427,896,2108,351,986,545,1122,284,445,468,72,396,613,169,292,49,546,6140
203086,"Meyers Leonard",870,324,698,135,350,189,348,87,102,540,88,452,163,33,88,37,313,2356
203087,"Jeremy Lamb",2844,1037,2302,250,730,787,1572,520,597,1022,144,878,433,176,213,87,376,5358
203089,"John Henson",1136,477,878,12,39,465,839,170,275,879,258,621,185,81,148,198,369,3280
203090,"Maurice Harkless",1618,650,1309,150,432,500,877,168,256,772,248,524,215,200,171,166,480,4902
203092,"Tyler Zeller",665,281,522,10,30,271,492,93,136,453,164,289,93,23,71,59,207,1730
203093,"Terrence Jones",586,232,496,19,77,213,419,103,171,310,65,245,59,40,49,54,68,1277
203094,"Andrew Nicholson",100,43,111,5,27,38,84,9,14,61,15,46,10,16,17,6,55,342
203095,"Evan Fournier",3406,1244,2801,408,1145,836,1656,510,620,647,105,542,662,184,390,32,543,6629
203096,"Jared Sullinger",37,15,47,3,18,12,29,4,8,27,10,17,3,4,4,1,17,119
203098,"John Jenkins",128,44,110,23,60,21,50,17,20,38,6,32,23,0,9,2,10,345
203101,"Miles Plumlee",430,181,320,0,0,181,320,68,129,362,131,231,83,41,103,47,166,1576
203107,"Tomas Satoransky",1387,519,1061,120,300,399,761,229,289,595,179,416,777,160,241,34,363,4528
203109,"Jae Crowder",2723,922,2188,440,1257,482,931,439,562,1074,167,907,387,201,239,75,518,6601
203110,"Draymond Green",2035,741,1691,205,684,536,1007,348,477,1615,233,1382,1495,344,555,267,599,6825
203112,"Quincy Acy",650,204,553,141,397,63,156,101,130,397,63,334,83,48,85,48,240,2042
203114,"Khris Middleton",3485,1249,2753,370,985,879,1768,617,712,1013,106,907,758,240,430,35,521,6270
203115,"Will Barton",2582,945,2154,310,853,635,1301,382,490,867,160,707,661,148,311,102,360,5575
203118,"Mike Scott",1172,461,1003,171,442,290,561,79,117,560,103,457,163,53,131,26,316,2996
203120,"Justin Hamilton",442,174,379,55,180,119,199,39,52,262,71,191,55,29,43,43,91,1176
203121,"Darius Miller",1204,405,971,280,722,125,249,114,138,292,32,260,257,68,117,40,325,3704
203124,"Kyle O'Quinn",1202,508,933,7,46,501,887,179,231,1028,307,721,331,81,207,227,434,2991
203138,"Hollis Thompson",205,77,200,32,95,45,105,19,29,112,19,93,35,20,11,6,69,753
203141,"Mirza Teletovic",522,181,475,125,350,56,125,35,45,185,14,171,58,16,44,14,123,1297
203145,"Kent Bazemore",2416,857,2088,296,840,561,1248,406,544,740,107,633,557,280,403,139,482,5395
203148,"Brian Roberts",142,46,122,17,44,29,78,33,39,39,5,34,52,9,26,1,18,412
203186,"Willie Reed",569,243,406,2,6,241,400,81,143,453,164,289,36,27,50,69,193,1456
203200,"Justin Holiday",2362,823,2097,420,1187,403,910,296,350,839,104,735,401,266,263,98,407,6512
203210,"JaMychal Green",1869,703,1464,169,448,534,1016,294,379,1417,418,999,213,124,257,93,594,5009
203263,"James Nunnally",36,12,34,8,25,4,9,4,4,5,0,5,7,1,1,0,10,102
203382,"Aron Baynes",1131,458,948,24,82,434,866,191,234,1007,329,678,182,51,170,124,491,3473
203457,"Nerlens Noel",954,401,690,0,2,401,688,152,218,787,268,519,115,162,125,168,351,2575
203458,"Alex Len",2054,764,1489,78,219,686,1270,448,655,1452,489,963,212,92,277,228,600,4502
203459,"Allen Crabbe",2248,777,1847,433,1093,344,754,261,315,698,63,635,257,124,186,68,441,5589
203460,"Andre Roberson",716,302,625,53,220,249,405,59,149,588,173,415,125,139,81,114,293,3420
203461,"Anthony Bennett",115,38,92,13,48,25,44,26,36,78,25,53,12,5,12,3,18,265
203462,"Archie Goodwin",110,36,66,5,15,31,51,33,42,28,7,21,24,4,14,5,8,213
203463,"Ben McLemore",992,362,856,137,370,225,486,131,169,285,56,229,106,73,128,24,269,2424
203464,"Brandon Paul",147,55,127,15,54,40,73,22,43,68,6,62,37,25,29,7,58,572
203468,"CJ McCollum",5037,1930,4189,541,1360,1389,2829,636,736,892,175,717,764,204,429,105,542,8088
203469,"Cody Zeller",1369,528,944,8,26,520,918,305,422,915,312,603,232,114,160,120,434,3593
203471,"Dennis Schroder",3939,1505,3464,300,920,1205,2544,629,747,740,124,616,1239,211,613,34,485,6875
203473,"Dewayne Dedmon",1697,670,1262,133,358,537,904,224,292,1465,334,1131,224,146,230,183,556,4481
203476,"Gorgui Dieng",1771,707,1426,54,160,653,1266,303,375,1318,375,943,301,181,223,175,535,5019
203477,"Isaiah Canaan",534,179,474,81,256,98,218,95,108,153,18,135,197,52,85,4,123,1647
203481,"Jeff Withey",161,61,119,2,11,59,108,37,50,131,53,78,7,16,16,35,55,470
203482,"Kelly Olynyk",2337,837,1708,287,791,550,917,376,482,1167,234,933,495,159,357,101,612,5125
203484,"Kentavious Caldwell-Pope",2977,1035,2482,463,1287,572,1195,444,537,873,163,710,465,268,248,41,400,7017
203485,"Lorenzo Brown",87,37,105,8,40,29,65,5,5,46,6,40,41,17,19,5,29,351
203486,"Mason Plumlee",2003,817,1433,2,17,815,1416,367,677,1529,467,1062,669,184,362,249,662,5322
203487,"Michael Carter-Williams",670,234,658,39,161,195,497,163,219,361,80,281,299,102,138,61,249,2052
203488,"Mike Muscala",1289,458,1010,197,533,261,477,176,211,714,189,525,222,83,145,106,307,3603
203490,"Otto Porter Jr.",2989,1158,2331,390,910,768,1421,283,343,1320,275,1045,398,314,184,114,452,6719
203493,"Reggie Bullock",1550,566,1268,301,747,265,521,117,141,391,62,329,253,105,122,28,201,4076
203496,"Robert Covington",2338,793,1930,425,1187,368,743,327,399,1062,175,887,304,338,304,188,567,5846
203497,"Rudy Gobert",3177,1165,1781,0,1,1165,1780,847,1297,2677,788,1889,338,159,384,530,630,7130
203498,"Shabazz Muhammad",986,372,786,56,172,316,614,186,240,296,107,189,49,31,62,9,116,1932
203499,"Shane Larkin",231,84,219,31,86,53,133,32,37,92,15,77,98,29,33,2,58,776
203500,"Steven Adams",3069,1303,2176,0,5,1303,2171,463,835,2058,1056,1002,298,298,409,232,614,7545
203501,"Tim Hardaway Jr.",3313,1165,2761,441,1304,724,1457,542,669,670,100,570,496,171,303,33,367,6092
203503,"Tony Snell",1643,594,1327,333,827,261,500,122,148,546,60,486,262,128,114,60,330,5691
203504,"Trey Burke",1377,545,1187,125,334,420,853,162,210,217,48,169,429,68,140,16,155,2614
203506,"Victor Oladipo",3477,1301,2862,362,1002,939,1860,513,663,883,107,776,685,315,420,89,402,5932
203507,"Giannis Antetokounmpo",5840,2119,3908,144,523,1975,3385,1458,1939,2351,457,1894,1219,332,725,367,709,7967
203512,"Lucas Nogueira",375,152,236,8,31,144,205,63,95,331,100,231,64,75,62,132,186,1507
203516,"James Ennis III",1330,466,999,157,446,309,553,241,307,665,202,463,176,134,149,60,449,4334
203518,"Alex Abrines",924,305,789,219,595,86,194,95,108,248,49,199,88,92,72,22,291,2777
203521,"Matthew Dellavedova",1023,361,928,152,423,209,505,149,175,288,44,244,683,81,250,2,295,3511
203524,"Solomon Hill",783,262,697,130,392,132,305,129,166,476,94,382,218,102,122,43,284,3437
203526,"Raul Neto",479,184,403,49,138,135,265,62,77,141,17,124,202,48,86,13,135,1320
203527,"Ryan Kelly",25,8,28,4,10,4,18,5,6,18,1,17,8,4,4,5,5,111
203530,"Joffrey Lauvergne",601,246,526,33,103,213,423,76,120,422,135,287,111,34,89,9,128,1517
203546,"Ian Clark",1479,584,1311,189,560,395,751,122,154,337,45,292,294,94,170,26,292,3566
203552,"Seth Curry",1479,550,1168,250,573,300,595,129,152,299,52,247,255,115,153,19,223,3431
203584,"Troy Daniels",1572,530,1345,395,1007,135,338,117,141,300,47,253,120,72,128,14,306,3568
203585,"Rodney McGruder",1091,412,994,167,480,245,514,100,151,527,165,362,253,90,124,33,276,3816
203613,"Jonathon Simmons",1811,664,1532,127,410,537,1122,356,470,525,108,417,425,134,290,56,410,4492
203705,"Josh Magette",46,15,46,8,22,7,24,8,8,19,2,17,57,8,9,1,16,216
203710,"C.J. Williams",248,104,232,27,94,77,138,13,17,64,13,51,55,37,25,13,79,834
203894,"Shabazz Napier",1391,465,1149,192,538,273,611,269,325,331,52,279,360,154,197,32,189,3026
203895,"Jordan McRae",321,119,280,28,86,91,194,55,69,81,12,69,49,21,29,13,57,716
203897,"Zach LaVine",2782,992,2200,282,754,710,1446,516,622,548,68,480,494,125,343,40,299,4573
203898,"Tyler Ennis",452,184,432,41,126,143,306,43,54,140,28,112,191,55,83,12,133,1266
203901,"Elfrid Payton",2289,938,1991,103,343,835,1648,310,453,881,202,679,1242,215,458,79,405,5468
203902,"Semaj Christon",183,77,223,12,63,65,160,17,31,87,19,68,130,28,43,7,79,972
203903,"Jordan Clarkson",3693,1436,3205,373,1119,1063,2086,448,550,733,188,545,630,203,426,27,369,6499
203909,"KJ McDaniels",206,77,169,20,66,57,103,32,38,82,15,67,13,19,29,18,49,506
203912,"CJ Wilcox",21,8,31,3,15,5,16,2,2,12,4,8,12,2,6,1,8,111
203914,"Gary Harris",2758,1030,2182,345,891,685,1291,353,440,514,126,388,485,248,263,42,324,5727
203915,"Spencer Dinwiddie",2582,824,1968,303,904,521,1064,631,783,589,93,496,1020,152,346,63,492,5552
203917,"Nik Stauskas",1336,447,1126,242,647,205,479,200,243,417,43,374,308,75,205,43,218,3726
203918,"Rodney Hood",2435,886,2088,325,876,561,1212,338,399,524,63,461,317,142,190,35,383,5100
203920,"Khem Birch",418,159,277,0,1,159,276,100,144,370,149,221,72,33,41,50,128,1226
203922,"Glenn Robinson III",712,268,599,81,221,187,378,95,127,354,85,269,85,68,60,29,122,2373
203923,"James Young",85,30,72,15,45,15,27,10,15,28,6,22,6,10,5,2,19,282
203924,"Jerami Grant",2209,805,1607,190,519,615,1088,409,608,941,220,721,182,125,165,256,518,5790
203925,"Joe Harris",2315,833,1731,418,965,415,766,231,286,698,119,579,363,103,267,45,456,5409
203926,"Doug McDermott",1786,666,1427,253,630,413,797,201,244,488,77,411,204,50,136,29,305,4610
203930,"Sean Kilpatrick",1249,415,1029,151,452,264,577,268,314,367,27,340,203,58,173,11,151,2393
203932,"Aaron Gordon",3287,1238,2776,313,956,925,1820,498,695,1436,332,1104,575,181,358,141,455,6844
203933,"T.J. Warren",2994,1229,2488,123,368,1106,2120,413,533,846,281,565,224,192,194,109,443,5548
203935,"Marcus Smart",2093,697,1831,295,927,402,904,404,512,727,178,549,944,339,411,85,526,6215
203937,"Kyle Anderson",1177,474,923,43,131,431,792,186,267,855,165,690,421,220,191,123,289,4279
203939,"Dwight Powell",2002,739,1293,88,285,651,1008,436,580,1161,368,793,252,172,160,121,522,4661
203940,"Adreian Payne",84,30,64,5,18,25,46,19,25,42,11,31,7,10,10,7,38,177
203943,"Noah Vonleh",1162,441,944,73,223,368,721,207,308,1226,314,912,194,95,183,95,396,3864
203944,"Julius Randle",3863,1452,2766,94,303,1358,2463,865,1194,1924,493,1431,703,144,594,127,768,6556
203948,"Johnny O'Bryant III",209,83,201,17,49,66,152,26,31,112,38,74,20,9,21,7,55,461
203949,"James Michael McAdoo",155,64,124,4,15,60,109,23,44,93,34,59,18,18,20,30,48,476
203952,"Andrew Wiggins",4706,1776,4079,333,975,1443,3104,821,1152,1038,267,771,533,243,463,129,499,8571
203953,"Jabari Parker",2346,928,1895,157,454,771,1441,333,456,886,200,686,353,121,289,62,306,4196
203954,"Joel Embiid",3833,1290,2684,181,575,1109,2109,1072,1360,1804,364,1440,499,113,577,309,532,4857
203957,"Dante Exum",814,298,691,67,229,231,462,151,190,226,50,176,264,43,152,20,235,2128
203960,"JaKarr Sampson",183,73,135,10,24,63,111,27,37,110,26,84,13,12,12,25,56,472
203961,"Eric Moreland",150,69,129,1,1,68,128,11,29,298,85,213,82,32,46,52,125,849
203962,"Josh Huestis",173,66,193,35,119,31,74,6,21,170,46,124,23,15,26,46,82,1011
203966,"Jamil Wilson",105,38,81,27,63,11,18,2,4,32,3,29,10,5,8,8,34,274
203967,"Dario Saric",3039,1088,2513,381,1063,707,1450,482,577,1490,392,1098,511,153,428,59,504,6459
203991,"Clint Capela",2958,1277,1971,0,1,1277,1970,404,695,2176,717,1459,227,136,284,318,532,5839
203992,"Bogdan Bogdanovic",1907,705,1635,263,701,442,934,234,281,466,71,395,525,144,242,31,314,4123
203994,"Jusuf Nurkic",2919,1171,2311,3,37,1168,2274,574,848,1923,586,1337,499,185,494,288,658,5458
203998,"Bruno Caboclo",322,111,272,53,153,58,119,47,56,190,54,136,58,19,44,38,93,947
203999,"Nikola Jokic",4210,1614,3070,239,689,1375,2381,743,893,2386,635,1751,1397,259,629,171,654,6981
204001,"Kristaps Porzingis",2284,833,1874,202,542,631,1332,416,527,791,173,618,154,83,211,244,385,3718
204014,"Damjan Rudez",82,31,88,20,64,11,24,0,0,25,5,20,20,12,9,1,31,312
204020,"Tyler Johnson",2464,883,2061,302,834,581,1227,396,510,714,118,596,564,198,248,105,421,5764
204025,"Tim Frazier",950,347,837,94,285,253,552,162,213,456,93,363,777,133,234,18,342,3482
204028,"Tarik Black",563,225,421,2,13,223,408,111,172,506,207,299,52,50,93,74,280,1624
204037,"Travis Wear",75,25,72,17,47,8,25,8,8,38,0,38,7,4,6,5,30,229
204038,"Langston Galloway",1617,561,1472,330,906,231,566,165,201,419,89,330,236,118,88,19,270,4112
204060,"Joe Ingles",2515,898,1971,516,1226,382,745,203,274,935,82,853,1086,284,459,48,521,7121
204066,"John Holland",54,17,59,11,36,6,23,9,13,24,6,18,5,7,8,2,10,177
204456,"T.J. McConnell",1517,666,1352,52,159,614,1193,133,166,651,104,547,1095,305,362,40,366,5310
1626143,"Jahlil Okafor",1250,531,971,2,9,529,962,186,276,603,184,419,110,38,164,107,269,2428
1626144,"Emmanuel Mudiay",2029,742,1817,172,536,570,1281,373,482,526,88,438,651,125,376,43,278,4263
1626145,"Tyus Jones",1093,410,955,111,328,299,627,162,193,333,49,284,715,224,144,16,238,3795
1626147,"Justin Anderson",946,337,798,116,374,221,424,156,202,422,118,304,114,78,105,43,211,2207
1626148,"Anthony Brown",46,19,51,8,28,11,23,0,0,33,8,25,9,5,6,1,15,163
1626149,"Montrezl Harrell",2724,1119,1781,5,31,1114,1750,481,757,1060,368,692,300,127,244,204,524,4525
1626150,"Andrew Harrison",1012,314,842,95,323,219,519,289,371,287,52,235,399,95,178,49,366,2985
1626151,"Aaron Harrison",61,19,73,9,45,10,28,14,19,27,4,23,14,9,3,2,29,251
1626153,"Delon Wright",1358,492,1106,116,351,376,755,258,322,512,129,383,505,187,180,74,215,3584
1626155,"Sam Dekker",1094,451,944,89,309,362,635,103,170,606,191,415,160,100,98,37,201,3089
1626156,"D'Angelo Russell",3439,1288,3056,459,1297,829,1759,404,524,725,114,611,1115,223,576,53,364,5498
1626157,"Karl-Anthony Towns",5684,2122,3966,363,915,1759,3051,1077,1280,2973,797,2176,678,187,611,343,818,8500
1626158,"Richaun Holmes",1442,587,1018,31,108,556,910,237,334,853,266,587,179,104,132,163,427,3120
1626159,"Justise Winslow",1555,611,1462,152,420,459,1042,181,288,819,150,669,496,152,252,58,369,4271
1626161,"Willie Cauley-Stein",2508,1055,1995,4,16,1051,1979,394,652,1527,397,1130,446,226,262,162,559,5679
1626162,"Kelly Oubre Jr.",2501,879,2074,288,895,591,1179,455,576,949,191,758,229,222,243,111,610,5774
1626163,"Frank Kaminsky",2152,765,1816,270,767,495,1049,352,457,787,142,645,354,94,183,65,302,4550
1626164,"Devin Booker",4772,1647,3740,429,1203,1218,2537,1049,1224,758,111,647,954,175,699,48,610,6838
1626166,"Cameron Payne",631,247,631,87,261,160,370,50,65,189,34,155,274,68,110,22,160,1762
1626167,"Myles Turner",2985,1130,2288,172,468,958,1820,553,710,1537,333,1204,308,172,301,489,643,6497
1626168,"Trey Lyles",1710,636,1484,199,622,437,862,239,338,828,147,681,247,86,193,77,301,3667
1626169,"Stanley Johnson",1392,510,1365,174,603,336,762,198,262,658,103,555,305,211,229,52,404,4475
1626170,"Jerian Grant",1239,429,1024,150,431,279,593,231,301,380,67,313,619,154,184,22,303,3652
1626171,"Bobby Portis",2111,844,1814,187,510,657,1304,236,312,1197,343,854,230,101,214,54,369,3943
1626172,"Kevon Looney",902,385,647,4,24,381,623,128,216,756,321,435,194,95,99,126,381,2832
1626173,"Rashad Vaughn",206,80,212,40,118,40,94,6,11,70,7,63,36,24,20,13,47,669
1626174,"Christian Wood",207,73,140,9,31,64,109,52,71,112,31,81,10,10,24,16,28,356
1626175,"Jordan Mickey",131,54,116,2,17,52,99,21,33,115,31,84,16,9,27,16,48,426
1626176,"Rakeem Christmas",59,19,43,0,0,19,43,21,29,56,26,30,4,3,8,6,37,217
1626177,"Dakari Johnson",55,22,39,0,0,22,39,11,20,34,16,18,8,6,3,8,27,163
1626178,"Rondae Hollis-Jefferson",2148,777,1753,37,170,740,1583,557,752,1221,280,941,417,191,305,119,429,4918
1626179,"Terry Rozier",2018,725,1877,329,918,396,959,239,308,910,135,775,594,193,195,51,293,5127
1626181,"Norman Powell",1537,570,1280,177,529,393,751,220,273,427,56,371,262,128,201,43,334,3556
1626184,"Chasson Randle",408,131,315,62,162,69,153,84,105,88,16,72,131,34,62,5,130,1043
1626185,"Jarell Martin",845,322,751,63,180,259,571,138,177,553,150,403,99,59,125,66,353,2549
1626188,"Quinn Cook",900,359,757,138,330,221,427,44,56,246,33,213,231,36,95,4,164,1992
1626191,"Chris McCullough",82,34,74,2,15,32,59,12,19,44,16,28,6,2,5,7,15,173
1626192,"Pat Connaughton",960,365,812,157,443,208,369,73,93,471,107,364,241,62,93,49,224,3070
1626195,"Willy Hernangomez",1254,490,924,24,66,466,858,250,359,996,348,648,189,75,193,72,312,2630
1626196,"Josh Richardson",2793,1024,2424,366,1023,658,1401,379,450,716,158,558,669,260,318,148,531,6847
1626199,"Darrun Hilliard",143,52,145,12,52,40,93,27,35,40,2,38,44,13,32,2,46,475
1626202,"Joe Young",275,106,258,30,89,76,169,33,44,80,13,67,54,18,31,1,44,697
1626203,"Treveon Graham",514,179,452,87,240,92,212,69,96,250,70,180,99,52,47,10,195,1954
1626204,"Larry Nance Jr.",1649,679,1253,45,146,634,1107,246,351,1373,449,924,392,270,204,117,513,4655
1626209,"Mario Hezonja",1550,581,1411,175,563,406,848,213,269,666,89,577,256,168,232,54,318,3824
1626210,"Alan Williams",384,153,298,0,2,153,296,78,125,333,101,232,34,33,45,33,140,802
1626220,"Royce O'Neale",769,283,627,110,294,173,333,93,118,521,47,474,219,90,125,40,277,2823
1626224,"Cedi Osman",1229,450,1030,162,461,288,569,167,227,477,64,413,236,82,146,14,273,3113
1626245,"Cristiano Felicio",864,350,615,0,6,350,609,164,247,762,286,476,132,52,120,35,283,2764
1626246,"Boban Marjanovic",848,311,540,4,10,307,530,222,286,539,181,358,85,32,105,50,166,1309
1626254,"Maurice Ndour",98,39,86,1,7,38,79,19,26,64,22,42,8,15,12,8,30,334
1626257,"Salah Mejri",568,231,386,12,40,219,346,94,159,685,218,467,84,64,100,154,328,2037
1626259,"Malcolm Miller",73,24,54,18,42,6,12,7,8,20,5,15,4,2,6,3,15,196
1626273,"Marcelo Huertas",63,25,68,4,19,21,49,9,17,24,2,22,52,10,19,2,16,238
1626780,"Jonathan Gibson",140,49,118,21,57,28,61,21,29,25,1,24,30,8,24,0,26,271
1627098,"Malcolm Delaney",729,254,673,72,234,182,439,149,185,223,19,204,356,74,161,7,194,2262
1627215,"Walt Lemon Jr.",86,38,87,2,5,36,82,8,11,27,4,23,30,11,10,1,14,167
1627362,"Briante Weber",112,44,103,5,21,39,82,19,26,61,16,45,43,30,23,6,44,441
1627395,"Julian Washburn",40,16,48,5,24,11,24,3,4,41,8,33,14,13,7,2,16,252
1627732,"Ben Simmons",2616,1084,1958,0,17,1084,1941,448,769,1356,317,1039,1271,252,552,131,420,5432
1627733,"Dragan Bender",907,332,842,168,524,164,318,75,116,647,97,550,209,50,181,97,330,3473
1627734,"Domantas Sabonis",2383,945,1842,73,213,872,1629,420,582,1550,397,1153,445,127,380,94,659,5278
1627735,"Wade Baldwin IV",174,60,169,9,36,51,133,45,58,69,14,55,78,21,57,10,63,583
1627736,"Malik Beasley",1196,455,988,200,515,255,473,86,109,288,54,234,139,77,87,17,162,2626
1627737,"Marquese Chriss",1491,553,1289,144,486,409,803,241,384,885,212,673,165,135,251,151,549,3763
1627738,"Deyonta Davis",454,200,334,0,1,200,333,54,85,346,105,241,47,21,43,61,177,1296
1627739,"Kris Dunn",1511,619,1485,98,303,521,1182,175,242,574,67,507,775,250,343,84,518,4246
1627740,"Henry Ellenson",325,115,305,47,133,68,172,48,62,188,23,165,43,13,41,3,55,730
1627741,"Buddy Hield",3640,1366,3060,602,1438,764,1622,306,350,988,196,792,481,181,371,64,465,6525
1627742,"Brandon Ingram",2639,996,2176,127,386,869,1790,520,785,897,158,739,550,123,394,110,470,6019
1627743,"Demetrius Jackson",48,18,37,4,14,14,23,8,12,19,9,10,17,7,11,1,11,140
1627744,"Brice Johnson",47,22,49,0,1,22,48,3,5,34,10,24,3,11,6,7,13,109
1627745,"Damian Jones",174,72,112,0,0,72,112,30,52,112,45,67,30,14,26,32,92,586
1627746,"Skal Labissiere",879,348,725,27,72,321,653,156,209,492,158,334,110,46,121,68,225,2028
1627747,"Caris LeVert",1873,698,1598,192,583,506,1015,285,403,599,111,488,565,173,281,44,327,4160
1627748,"Thon Maker",905,322,765,108,331,214,434,153,226,541,156,385,114,69,94,130,351,2775
1627749,"Dejounte Murray",784,320,725,18,57,302,668,126,178,501,116,385,279,105,172,37,180,2060
1627750,"Jamal Murray",3530,1287,2965,432,1194,855,1771,524,596,828,188,640,807,197,443,79,450,6778
1627751,"Jakob Poeltl",1155,507,789,1,2,506,787,140,250,968,421,547,162,85,162,188,449,3427
1627752,"Taurean Prince",2235,791,1854,332,874,459,980,321,390,745,97,648,387,181,352,88,405,5001
1627753,"Zhou Qi",24,7,33,2,19,5,14,8,12,22,6,16,2,2,10,14,14,124
1627755,"Tyler Ulis",998,398,988,63,225,335,763,139,172,223,44,179,537,118,204,12,193,2780
1627756,"Denzel Valentine",1074,403,1009,216,578,187,431,52,69,544,59,485,307,95,148,18,271,3073
1627757,"Stephen Zimmerman",23,10,31,0,0,10,31,3,5,35,11,24,4,2,3,5,17,110
1627758,"Ron Baker",300,106,296,35,132,71,164,53,75,139,18,121,169,66,79,15,125,1393
1627759,"Jaylen Brown",2496,933,2017,262,716,671,1301,368,559,879,176,703,278,174,291,76,509,5409
1627761,"DeAndre' Bembry",924,375,842,62,221,313,621,112,185,489,76,413,279,134,205,58,249,2754
1627763,"Malcolm Brogdon",2393,912,1886,244,598,668,1288,325,363,657,135,522,674,171,270,38,370,5256
1627767,"Cheick Diallo",728,306,523,1,4,305,519,115,154,616,145,471,56,44,84,61,212,1674
1627770,"Kay Felder",223,83,228,11,41,72,187,46,61,59,6,53,78,21,46,8,49,527
1627772,"Daniel Hamilton",69,28,71,10,28,18,43,3,6,52,10,42,30,7,18,1,21,235
1627773,"AJ Hammons",48,17,42,5,10,12,32,9,20,36,8,28,4,1,10,13,21,160
1627774,"Jake Layman",653,256,560,76,252,180,308,65,91,257,66,191,75,46,62,37,151,1736
1627775,"Patrick McCaw",585,224,533,69,231,155,302,68,86,230,44,186,187,98,94,27,167,2437
1627777,"Georges Niang",265,99,228,44,121,55,107,23,28,113,16,97,43,15,31,6,64,644
1627780,"Gary Payton II",100,43,104,8,36,35,68,6,14,58,14,44,38,13,18,8,41,334
1627781,"Malachi Richardson",198,67,187,28,93,39,94,36,46,70,10,60,24,16,26,2,63,624
1627782,"Wayne Selden",910,337,810,111,324,226,486,125,173,252,54,198,188,57,145,19,208,2365
1627783,"Pascal Siakam",2172,875,1648,109,353,766,1295,313,421,1098,267,831,424,161,254,139,516,5082
1627784,"Jarrod Uthoff",40,16,38,3,9,13,29,5,7,22,8,14,9,2,3,4,8,116
1627785,"Isaiah Whitehead",643,244,594,51,167,193,427,104,132,210,36,174,212,50,166,38,198,1826
1627786,"Troy Williams",429,168,374,43,144,125,230,50,77,191,49,142,52,57,60,22,131,1179
1627788,"Furkan Korkmaz",302,106,273,52,161,54,112,38,48,118,18,100,56,31,27,3,74,762
1627789,"Timothe Luwawu-Cabarrot",975,327,846,139,435,188,411,182,222,318,50,268,155,63,132,23,324,2666
1627790,"Ante Zizic",578,232,398,0,0,232,398,114,161,380,132,248,58,15,72,35,143,1301
1627812,"Yogi Ferrell",1720,624,1476,256,684,368,792,216,259,469,59,410,510,142,188,22,307,4555
1627814,"Damion Lee",319,118,279,42,128,76,151,41,51,135,19,116,42,32,25,1,53,778
1627815,"Sheldon Mac",90,30,75,7,30,23,45,23,27,34,4,30,15,8,5,2,17,287
1627816,"Alex Poythress",197,76,161,19,53,57,108,26,39,122,47,75,24,10,18,13,77,564
1627819,"Isaiah Taylor",448,164,397,20,82,144,315,100,143,97,23,74,209,35,84,11,122,1218
1627820,"Tyrone Wallace",509,202,464,14,59,188,405,91,135,206,41,165,113,48,82,20,166,1477
1627821,"James Webb III",16,6,24,4,19,2,5,0,0,24,8,16,4,1,4,0,10,120
1627823,"Juancho Hernangomez",795,268,613,126,344,142,269,133,174,506,125,381,96,63,77,39,181,2478
1627824,"Guerschon Yabusele",173,61,138,21,65,40,73,30,44,105,40,65,31,12,27,12,55,491
1627826,"Ivica Zubac",970,399,739,0,4,399,735,172,226,644,201,443,118,36,126,99,250,2063
1627827,"Dorian Finney-Smith",1081,398,982,155,512,243,470,130,179,686,215,471,188,131,140,65,354,4075
1627832,"Fred VanVleet",1464,517,1256,231,586,286,670,199,238,393,50,343,585,141,171,42,276,3571
1627834,"Georgios Papagiannis",160,74,144,0,2,74,142,12,14,123,37,86,29,7,32,23,56,477
1627835,"Paul Zipser",458,169,455,70,209,99,246,50,65,256,28,228,82,35,83,31,164,1662
1627846,"Abdel Nader",387,141,364,55,165,86,199,50,75,187,27,160,46,35,60,22,113,1217
1627848,"Shawn Long",148,61,109,7,19,54,90,19,35,85,41,44,13,9,13,9,49,233
1627850,"Marshall Plumlee",54,17,33,0,0,17,33,20,35,68,27,41,12,4,15,5,33,223
1627851,"Mindaugas Kuzminskas",425,158,371,54,168,104,203,55,68,126,47,79,69,29,51,11,79,1021
1627852,"Nicolas Brussino",150,52,143,29,97,23,46,17,22,98,26,72,47,17,26,8,43,531
1627853,"Ryan Arcidiacono",592,204,459,90,248,114,211,94,108,244,28,216,304,78,76,4,189,2266
1627854,"Bryn Forbes",1616,606,1387,282,694,324,693,122,156,372,32,340,278,74,128,6,287,4095
1627855,"Okaro White",118,40,105,16,47,24,58,22,25,95,29,66,23,11,19,11,58,556
1627858,"Kyle Collinsworth",101,38,99,4,17,34,82,21,40,107,32,75,56,17,24,9,44,478
1627863,"Danuel House Jr.",518,174,381,89,236,85,145,81,102,217,38,179,65,28,46,17,103,1381
1627875,"Marcus Georges-Hunt",73,23,55,5,17,18,38,22,31,25,8,17,10,7,5,0,37,273
1627879,"Nicolas Laprovittola",59,20,47,10,27,10,20,9,9,10,1,9,28,4,19,1,19,173
1627883,"Jalen Jones",155,52,130,20,54,32,76,31,46,72,24,48,11,14,15,3,49,395
1627884,"Derrick Jones Jr.",651,249,498,34,120,215,378,119,187,357,156,201,58,64,63,68,210,1943
1627885,"Shaquille Harrison",626,243,550,30,115,213,435,110,161,283,42,241,194,115,82,37,166,1818
1627936,"Alex Caruso",363,127,289,37,93,90,196,72,94,132,35,97,152,47,84,19,106,1093
1627988,"Myke Henry",107,41,109,19,58,22,51,6,10,38,10,28,22,31,19,6,28,380
1628021,"David Nwaba",1009,375,766,43,132,332,634,216,327,552,147,405,172,108,117,53,300,3032
1628035,"Alfonzo McKinnie",358,142,290,45,127,97,163,29,51,254,82,172,32,19,33,16,142,1057
1628365,"Markelle Fultz",255,110,266,4,15,106,251,31,58,113,37,76,112,29,42,9,74,678
1628366,"Lonzo Ball",993,388,1020,165,523,223,497,52,119,611,123,488,631,157,239,62,231,3203
1628367,"Josh Jackson",1922,736,1773,130,442,606,1331,320,492,698,161,537,302,154,319,91,427,3950
1628368,"De'Aaron Fox",2243,833,1899,133,385,700,1514,444,612,508,76,432,910,203,400,65,367,4573
1628369,"Jayson Tatum",2355,863,1871,221,553,642,1318,408,486,879,120,759,296,167,236,115,338,4897
1628370,"Malik Monk",1074,380,1011,192,573,188,438,122,140,203,24,179,208,57,135,28,166,2112
1628371,"Jonathan Isaac",865,317,756,102,312,215,444,129,160,510,115,395,98,92,102,128,191,2533
1628372,"Dennis Smith Jr.",1770,682,1674,173,547,509,1127,233,349,415,82,333,610,138,348,38,281,3559
1628373,"Frank Ntilikina",709,277,782,83,272,194,510,72,98,264,49,215,371,95,187,32,285,2612
1628374,"Lauri Markkanen",2007,716,1657,265,733,451,924,310,361,978,153,825,154,76,168,73,225,3705
1628378,"Donovan Mitchell",3445,1256,2892,375,1069,881,1823,558,693,612,111,501,613,224,433,58,421,5237
1628379,"Luke Kennard",1171,434,985,187,464,247,521,116,137,359,33,326,238,70,126,23,178,2907
1628380,"Zach Collins",804,304,689,75,234,229,455,121,168,545,154,391,123,42,135,97,307,2398
1628381,"John Collins",1965,779,1376,71,205,708,1171,336,452,1136,395,741,219,69,225,119,414,3613
1628382,"Justin Jackson",1036,402,904,144,430,258,474,88,115,399,71,328,170,60,69,27,180,3123
1628384,"OG Anunoby",907,346,750,140,399,206,351,75,124,381,102,279,102,98,100,36,270,2839
1628385,"Harry Giles III",408,175,348,0,6,175,342,58,91,222,66,156,85,31,73,22,150,821
1628386,"Jarrett Allen",1460,569,965,11,60,558,905,311,425,1060,335,725,159,71,185,208,331,3532
1628388,"TJ Leaf",381,163,319,26,73,137,246,29,47,207,72,135,33,14,22,23,80,980
1628389,"Bam Adebayo",1206,454,826,3,22,451,804,295,405,978,283,695,285,103,187,106,341,3277
1628390,"Terrance Ferguson",702,255,600,146,410,109,190,46,61,188,52,136,91,64,58,26,314,2700
1628391,"D.J. Wilson",301,113,267,48,132,65,135,27,49,232,47,185,55,21,36,21,92,952
1628392,"Isaiah Hartenstein",53,20,41,2,6,18,35,11,14,47,21,26,15,7,13,12,56,224
1628393,"Jawun Evans",237,92,267,15,57,77,210,38,49,96,10,86,110,39,50,6,105,842
1628395,"Jordan Bell",485,215,377,0,6,215,371,55,85,391,115,276,178,55,93,107,172,1602
1628397,"Ivan Rabb",485,202,364,3,15,199,349,78,105,364,123,241,86,29,70,27,145,1241
1628398,"Kyle Kuzma",2550,964,2126,287,856,677,1270,335,458,865,148,717,319,90,273,60,330,4714
1628400,"Semi Ojeleye",381,132,346,68,214,64,132,49,80,247,61,186,43,31,44,8,134,1750
1628401,"Derrick White",717,276,576,56,155,220,421,109,143,273,40,233,272,71,103,50,153,1867
1628402,"Frank Jackson",495,194,447,53,169,141,278,54,73,134,25,109,69,25,48,2,92,1171
1628403,"Caleb Swanigan",104,42,113,2,15,40,98,18,27,118,32,86,25,11,36,4,65,373
1628404,"Josh Hart",1021,365,839,170,471,195,368,121,174,511,77,434,173,111,105,56,254,3174
1628405,"Johnathan Motley",198,79,148,1,9,78,139,39,68,100,32,68,18,8,25,5,45,327
1628407,"Dwayne Bacon",491,194,449,49,130,145,319,54,71,213,12,201,85,28,41,7,118,1472
1628409,"Alec Peters",82,28,74,18,58,10,16,8,10,37,8,29,12,2,4,2,13,224
1628410,"Edmond Sumner",68,23,65,7,27,16,38,15,24,25,9,16,10,12,10,5,27,209
1628411,"Wes Iwundu",568,206,492,38,125,168,367,118,150,321,73,248,130,61,74,34,204,2247
1628412,"Frank Mason",608,215,549,45,150,170,399,133,172,173,36,137,231,50,101,14,106,1424
1628413,"Jonah Bolden",207,80,162,34,96,46,66,13,27,165,47,118,40,17,36,39,99,641
1628414,"Sindarius Thornwell",344,117,282,26,76,91,206,84,122,184,38,146,86,62,73,32,166,1475
1628415,"Dillon Brooks",1033,389,894,109,304,280,590,146,196,288,58,230,151,83,143,21,283,2682
1628416,"Tyler Dorsey",701,251,646,116,331,135,315,83,124,243,44,199,135,31,64,7,116,1677
1628417,"Jaron Blossomgame",114,47,106,10,39,37,67,10,13,98,26,72,13,7,11,8,20,441
1628418,"Thomas Bryant",780,317,523,34,109,283,414,112,146,471,116,355,98,26,62,69,132,1567
1628420,"Monte Morris",861,350,708,94,228,256,480,67,83,196,35,161,304,76,53,4,103,1996
1628421,"Devin Robinson",49,20,35,0,2,20,33,9,14,25,8,17,6,5,2,6,13,108
1628422,"Damyean Dotson",961,362,859,148,410,214,449,89,121,346,43,303,166,70,88,12,169,2475
1628424,"Kobi Simmons",196,80,189,11,39,69,150,25,25,50,14,36,68,18,44,5,61,647
1628425,"Sterling Brown",589,227,517,85,238,142,279,50,66,327,56,271,109,56,71,21,168,1810
1628432,"Davon Reed",75,27,88,13,42,14,46,8,12,45,4,41,16,11,11,2,20,288
1628436,"Luke Kornet",456,156,408,98,272,58,136,46,57,199,39,160,80,33,37,58,69,1109
1628439,"Isaiah Hicks",92,37,80,2,9,35,71,16,23,48,12,36,18,3,17,7,50,271
1628443,"Kadeem Allen",208,71,163,17,47,54,116,49,63,62,12,50,88,19,35,6,61,520
1628444,"Jabari Bird",39,15,26,3,7,12,19,6,13,19,6,13,8,3,8,1,7,115
1628449,"Chris Boucher",93,34,77,12,38,22,39,13,15,57,16,41,2,6,7,24,31,166
1628455,"Mike James",336,123,321,26,98,97,223,64,84,90,13,77,126,28,49,7,48,688
1628462,"Milos Teodosic",477,168,400,98,259,70,141,43,53,142,19,123,241,26,118,6,130,1287
1628463,"Tyler Cavanaugh",192,70,162,33,94,37,68,19,23,135,48,87,28,9,14,4,64,563
1628464,"Daniel Theis",705,272,499,44,125,228,374,117,157,499,177,322,124,51,89,90,318,1839
1628467,"Maxi Kleber",871,326,695,117,346,209,349,102,133,563,161,402,121,62,84,125,257,2714
1628469,"Antonio Blakeney",569,219,539,51,143,168,396,80,115,139,11,128,62,19,46,10,60,1143
1628470,"Torrey Craig",593,222,499,78,246,144,253,71,105,390,129,261,97,49,64,61,238,2131
1628476,"Derrick Walton Jr.",29,8,25,7,17,1,8,6,6,16,2,14,16,7,2,3,7,148
1628495,"Milton Doyle",34,13,47,4,23,9,24,4,8,18,3,15,10,6,2,2,13,124
1628499,"Antonius Cleveland",23,8,21,3,4,5,17,4,6,14,3,11,2,7,7,5,23,122
1628502,"Nigel Hayes",27,11,33,4,16,7,17,1,3,22,4,18,6,2,2,3,8,123
1628503,"Jamel Artis",77,31,79,8,29,23,50,7,12,38,4,34,18,2,8,3,11,279
1628504,"Xavier Rathan-Mayes",29,12,42,1,14,11,28,4,9,5,0,5,18,6,11,3,18,118
1628510,"Andrew White III",69,25,73,18,49,7,24,1,4,34,4,30,6,3,8,1,12,208
1628515,"Isaiah Briscoe",136,55,138,11,34,44,104,15,26,74,5,69,87,11,31,2,66,558
1628537,"Jaylen Morris",38,17,42,3,13,14,29,1,2,21,2,19,11,4,7,1,3,128
1628681,"Rodney Purvis",96,35,107,13,52,22,55,13,15,27,1,26,17,3,10,3,26,291
1628959,"Rawle Alkins",37,13,39,3,12,10,27,8,12,26,11,15,13,1,8,0,7,121
1628960,"Grayson Allen",211,67,178,32,99,35,79,45,60,23,3,20,25,6,33,6,47,414
1628963,"Marvin Bagley III",923,356,706,30,96,326,610,181,262,471,162,309,62,33,98,59,120,1565
1628964,"Mo Bamba",292,117,243,21,70,96,173,37,63,233,64,169,39,13,43,64,102,766
1628966,"Keita Bates-Diop",151,60,142,13,52,47,90,18,28,83,16,67,17,18,14,14,29,503
1628969,"Mikal Bridges",684,242,563,105,313,137,250,95,118,264,56,208,173,129,70,38,201,2419
1628970,"Miles Bridges",597,237,511,65,200,172,311,58,77,323,67,256,95,55,50,49,111,1696
1628971,"Bruce Brown",319,125,314,24,93,101,221,45,60,185,48,137,91,40,46,36,178,1447
1628972,"Troy Brown Jr.",248,97,234,22,69,75,165,32,47,145,35,110,80,21,30,5,56,728
1628973,"Jalen Brunson",678,264,565,63,181,201,384,87,120,169,25,144,230,37,88,4,127,1594
1628975,"Jevon Carter",172,56,185,34,102,22,83,26,32,66,14,52,69,26,33,11,55,575
1628976,"Wendell Carter Jr.",455,180,371,6,32,174,339,89,112,307,87,220,78,26,65,58,152,1112
1628977,"Hamidou Diallo",190,75,165,4,24,71,141,36,59,97,38,59,17,21,23,10,77,527
1628978,"Donte DiVincenzo",131,50,124,22,83,28,41,9,12,65,16,49,31,13,19,6,38,413
1628980,"Jacob Evans",40,18,53,4,15,14,38,0,1,25,6,19,23,5,11,3,28,200
1628983,"Shai Gilgeous-Alexander",889,341,716,51,139,290,577,156,195,232,57,175,270,96,141,45,175,2175
1628984,"Devonte' Graham",217,74,216,34,121,40,95,35,46,63,10,53,121,23,30,2,48,679
1628988,"Aaron Holiday",294,105,262,43,127,62,135,41,50,67,5,62,87,21,40,13,71,645
1628989,"Kevin Huerter",727,275,657,136,353,139,304,41,56,245,60,185,214,65,109,25,155,2042
1628990,"Chandler Hutchison",229,96,209,14,50,82,159,23,38,185,31,154,34,23,25,6,59,893
1628991,"Jaren Jackson Jr.",798,298,589,51,142,247,447,151,197,272,73,199,64,52,98,82,220,1516
1628995,"Kevin Knox II",963,338,914,125,364,213,550,162,226,335,61,274,82,43,114,24,175,2158
1629001,"De'Anthony Melton",250,100,256,29,95,71,161,21,28,134,25,109,159,68,75,23,113,981
1629002,"Chimezie Metu",51,19,58,0,2,19,56,13,17,36,9,27,13,6,15,2,14,142
1629003,"Shake Milton",87,34,87,14,44,20,43,5,7,35,9,26,18,8,6,8,29,268
1629004,"Svi Mykhailiuk",133,46,140,29,89,17,51,12,20,36,9,27,37,14,21,1,25,443
1629006,"Josh Okogie",570,196,508,60,215,136,293,118,162,218,41,177,91,88,63,33,166,1761
1629010,"Jerome Robinson",112,44,110,18,57,26,53,6,9,41,3,38,19,11,13,3,46,320
1629011,"Mitchell Robinson",485,202,291,0,0,202,291,81,135,423,177,246,37,52,35,161,217,1361
1629012,"Collin Sexton",1371,519,1206,119,296,400,910,214,255,236,57,179,243,44,185,6,186,2611
1629013,"Landry Shamet",722,240,557,167,396,73,161,75,93,134,21,113,117,37,45,10,155,1802
1629014,"Anfernee Simons",75,28,63,10,29,18,34,9,16,13,3,10,13,1,11,0,9,139
1629015,"Zhaire Smith",40,14,34,6,16,8,18,6,8,13,3,10,10,2,6,2,8,112
1629016,"Omari Spellman",272,98,244,44,128,54,116,32,45,194,72,122,47,26,31,25,67,805
1629017,"Khyri Thomas",61,22,69,10,35,12,34,7,11,20,4,16,8,7,4,5,22,196
1629018,"Gary Trent Jr.",40,16,50,5,21,11,29,3,7,11,1,10,5,1,4,2,4,111
1629019,"Allonzo Trier",695,232,518,52,132,180,386,179,223,197,31,166,119,28,116,14,117,1460
1629021,"Moritz Wagner",207,71,171,22,77,49,94,43,53,85,17,68,24,11,39,13,57,447
1629022,"Lonnie Walker IV",45,16,46,5,13,11,33,8,10,17,0,17,9,7,4,3,7,118
1629026,"Kenrich Williams",279,107,279,52,156,55,123,13,19,219,55,164,83,45,36,19,95,1083
1629027,"Trae Young",1549,525,1256,156,482,369,774,343,414,301,64,237,653,72,308,15,140,2503
1629028,"Deandre Ayton",1159,509,870,0,4,509,866,141,189,729,223,506,125,61,126,67,209,2182
1629029,"Luka Doncic",1526,506,1186,168,514,338,672,346,485,563,86,477,429,77,247,25,137,2322
1629033,"Theo Pinson",81,25,73,12,46,13,27,19,22,36,4,32,21,6,18,0,15,210
1629034,"Ray Spalding",54,25,47,0,3,25,44,4,12,48,15,33,5,9,9,8,23,148
1629057,"Robert Williams III",81,36,51,0,0,36,51,9,15,81,27,54,7,9,10,40,36,281
1629059,"Elie Okobo",304,114,290,39,132,75,158,37,47,98,12,86,127,32,69,7,109,961
1629061,"Deng Adel",32,11,36,6,23,5,13,4,4,19,3,16,5,1,6,4,13,196
1629066,"Rodions Kurucs",534,202,449,58,184,144,265,72,92,246,56,190,52,41,77,25,146,1293
1629067,"Isaac Bonga",19,5,33,0,8,5,25,9,15,25,9,16,15,9,6,4,9,119
1629102,"Brandon Sampson",71,28,60,11,29,17,31,4,6,16,3,13,10,8,12,3,19,214
1629109,"Gary Clark",148,50,151,41,138,9,13,7,7,116,24,92,18,20,7,26,47,637
1629121,"Jaylen Adams",108,38,110,25,74,13,36,7,9,60,11,49,65,14,28,5,45,425
1629123,"Jared Terrell",31,12,39,4,17,8,22,3,6,6,1,5,12,3,10,2,16,112
1629126,"Deonte Burton",82,33,82,8,27,25,55,8,12,28,4,24,9,6,9,8,31,239
1629130,"Duncan Robinson",50,18,46,10,35,8,11,4,6,19,2,17,5,5,4,0,11,161
1629139,"Yuta Watanabe",39,15,51,2,16,13,35,7,10,31,4,27,8,4,6,1,11,176
1629140,"Johnathan Williams",157,65,110,0,2,65,108,27,48,99,48,51,13,8,16,7,62,371
1629151,"Ryan Broekhoff",167,57,126,38,93,19,33,15,19,63,8,55,22,6,16,4,35,456
1629203,"Jemerrio Jones",27,12,33,2,10,10,23,1,2,49,16,33,13,7,5,5,10,142
1629234,"Drew Eubanks",41,15,26,0,0,15,26,11,13,34,6,28,7,2,8,5,11,111
1629244,"Cameron Reynolds",95,33,78,21,51,12,27,8,9,31,4,27,13,6,5,2,26,258
1629541,"Dairis Bertans",34,12,47,10,34,2,13,0,0,9,2,7,10,1,2,0,7,167
